#.......................................
#.......................................
#.......................................
#.......................................
#.......................................
#.......................................
#....#..........#.......................
#....############.......................
#.....##########........................
#.......................................
#.......................................
#.........................#........#....
#.........................##########....
#..........................########.....
#................####...................
#................####...................
###..............####...................
###..............####...................
###.....................................
######..................................
######..................................
######..................................
#########...............................
#########...............................
#########...............................
############............................
############............................
############............................
########################################
########################################